0  0  1  2  3  4  5  6  7  8  8  9  10 10 10 11 10 10 10 10 
0  0  1  2  3  4  5  6  7  8  8  9  10 10 10 10 10 10 10 10 
0  0  1  2  3  4  5  6  7  7  8  9  9  10 10 10 10 10 10 10 
0  0  1  1  2  3  5  6  6  7  8  9  9  10 10 10 10 10 10 10 
0  0  1  1  2  3  4  5  6  7  8  8  9  10 10 10 10 10 10 10 
0  0  1  1  2  3  4  5  6  7  8  8  9  9  10 10 10 10 10 10 
0  0  1  1  2  3  4  5  6  7  7  8  9  9  9  10 10 10 10 9  
0  0  1  1  2  3  4  5  6  7  7  8  8  9  9  9  10 9  9  9  
0  1  1  1  2  3  4  5  6  6  7  8  8  9  9  9  9  9  9  9  
1  1  1  2  2  3  4  5  6  6  7  8  8  9  9  9  9  9  9  9  
1  1  1  2  2  3  4  5  5  6  7  7  8  8  9  9  9  9  9  9  
1  1  1  2  2  3  4  4  5  6  6  7  8  8  8  8  9  9  8  8  
1  1  1  2  2  3  4  4  5  6  6  7  7  8  8  8  8  8  8  8  
1  1  1  2  2  3  3  4  5  5  6  6  7  7  8  8  8  8  8  8  
1  1  2  2  2  3  3  4  5  5  6  6  7  7  7  8  8  8  8  8  
1  1  2  2  2  3  3  4  4  5  6  6  7  7  7  7  7  8  8  8  
1  1  1  2  2  3  3  4  4  5  6  6  7  7  7  7  7  7  7  8  
1  1  2  2  2  3  3  4  4  5  5  6  6  7  7  7  7  7  7  7  
1  1  2  2  2  3  3  4  4  5  5  6  6  7  7  7  7  7  7  7  
2  2  2  2  2  3  3  4  4  5  5  6  6  6  7  7  7  7  7  7  
