4  3  3  3  3  2  2  1  1  1  1  0  0  0  0  0  0  0  0  0  
4  3  3  3  3  2  2  2  1  1  1  0  0  0  0  0  0  0  0  0  
4  4  3  3  3  3  2  2  2  1  1  1  1  0  0  0  0  0  0  0  
4  4  4  3  3  3  3  2  2  2  2  1  1  1  1  1  0  0  0  0  
4  4  4  4  3  3  3  3  3  2  2  2  2  1  1  1  1  1  1  1  
4  4  4  4  4  4  3  3  3  3  3  2  2  2  2  2  2  2  2  2  
4  4  4  4  4  4  4  4  4  3  3  3  3  3  3  3  3  2  2  2  
4  4  4  4  4  4  4  4  4  4  4  4  4  3  3  3  3  3  3  3  
4  4  4  4  4  4  4  4  4  4  4  4  4  4  4  4  4  4  4  3  
4  4  4  4  4  5  5  5  5  5  5  5  4  4  4  4  4  4  4  4  
4  4  4  4  5  5  5  5  5  5  5  5  5  5  5  5  5  5  5  4  
4  4  4  5  5  5  5  5  5  6  6  5  5  5  5  5  5  5  5  5  
4  4  4  5  5  5  5  6  6  6  6  6  6  6  6  6  6  6  6  6  
4  4  5  5  5  5  6  6  6  6  6  6  6  6  6  6  6  6  6  6  
4  4  5  5  5  5  6  6  6  6  6  7  7  7  7  7  7  7  7  6  
4  4  5  5  5  6  6  6  6  6  7  7  7  7  7  7  7  7  7  7  
4  4  5  5  5  6  6  6  6  6  7  7  7  7  7  7  7  7  7  7  
4  4  5  5  5  6  6  6  6  7  7  7  7  7  7  7  7  7  7  7  
4  5  5  5  5  6  6  6  6  7  7  7  7  7  7  7  7  7  7  7  
5  5  5  5  5  6  6  6  7  7  7  7  7  7  7  7  7  8  7  7  
