6  7  7  7  7  7  8  8  8  8  8  9  9  9  9  9  9  9  9  10 
6  6  6  7  7  7  7  8  8  8  8  9  9  9  9  9  9  9  9  9  
6  6  6  6  6  7  7  7  7  7  8  8  8  9  9  9  9  9  9  9  
5  5  5  6  6  6  6  6  7  7  7  7  8  8  8  8  8  8  8  8  
5  5  5  5  5  5  6  6  6  6  6  7  7  7  7  7  7  8  8  8  
4  4  4  4  4  5  5  5  5  5  5  6  6  7  7  7  7  7  7  7  
4  4  4  4  4  4  4  4  4  4  5  5  5  6  6  6  6  6  6  7  
3  3  3  3  3  3  3  4  4  4  4  4  5  5  5  5  5  5  6  6  
3  3  3  3  2  3  3  3  3  3  3  4  4  4  4  4  4  4  5  5  
2  2  2  2  2  2  2  2  3  3  3  3  3  3  4  4  4  4  4  5  
2  2  2  2  2  2  2  2  2  2  2  2  2  3  3  3  3  3  3  4  
2  2  2  1  1  1  1  1  1  1  1  2  2  2  2  2  2  2  3  3  
2  1  1  1  1  1  1  1  1  1  1  1  1  2  2  2  2  2  2  3  
1  1  1  1  1  1  1  0  0  0  0  1  1  1  1  1  2  2  2  2  
1  1  1  1  0  0  0  0  0  0  0  0  1  1  1  1  1  2  2  2  
1  1  1  0  0  0  0  0  0  0  0  0  1  1  1  1  2  2  2  2  
1  1  1  0  0  0  0  0  0  0  0  0  1  1  1  2  2  2  2  2  
1  1  1  0  0  0  0  0  0  0  0  0  1  1  1  2  2  2  2  2  
1  1  1  0  0  0  0  0  0  0  0  1  1  1  2  2  2  2  2  2  
1  1  1  1  0  0  0  0  0  0  1  1  1  1  2  2  2  2  2  2  
