11 10 10 10 9  8  8  7  7  6  6  5  4  3  3  2  2  2  1  0  
10 10 10 10 9  8  8  7  7  6  5  5  4  3  3  2  2  2  1  0  
10 10 10 9  9  8  8  7  7  6  5  5  4  3  3  2  2  2  1  0  
10 10 10 9  9  8  8  7  6  6  5  4  4  3  3  2  2  2  1  0  
10 10 9  9  9  8  7  7  6  6  5  4  4  3  2  2  2  2  1  0  
9  9  9  9  9  8  7  7  6  6  5  4  4  3  2  2  2  2  1  0  
9  9  9  9  8  8  7  7  6  6  5  4  4  3  2  2  2  1  1  0  
9  9  9  8  8  8  7  7  6  6  5  4  4  3  2  2  1  1  1  0  
9  9  8  8  8  8  7  7  6  6  5  4  4  3  2  1  1  1  0  0  
8  8  8  8  8  7  7  7  6  6  5  4  3  3  2  1  1  1  0  0  
8  8  8  8  7  7  7  7  6  6  5  4  3  3  2  2  1  1  1  0  
7  7  7  7  7  7  7  7  6  6  5  4  4  3  2  2  2  2  1  0  
7  7  7  7  7  7  7  7  6  6  5  4  4  3  3  2  2  2  2  1  
6  6  7  7  7  7  7  6  6  6  5  5  4  4  3  3  3  3  2  1  
6  6  6  6  6  6  6  6  6  6  5  5  4  4  4  3  3  3  2  1  
6  6  6  6  6  6  6  6  6  6  5  5  4  4  4  4  4  3  2  1  
6  6  6  6  6  6  6  6  6  5  5  5  4  4  4  4  4  3  3  1  
6  6  6  6  6  6  6  6  6  5  5  5  4  4  4  4  4  3  3  1  
6  6  6  6  6  6  6  6  5  5  5  5  4  4  4  4  4  4  3  2  
6  6  6  5  6  6  5  5  5  5  5  5  5  5  5  5  5  4  3  2  
