11 10 10 10 9  8  8  7  7  6  6  5  5  4  4  4  4  3  3  3  
10 10 10 9  9  8  8  7  7  6  6  5  5  4  4  4  4  3  3  3  
10 9  9  9  9  8  8  7  7  6  6  5  5  4  4  4  4  4  3  3  
9  9  9  8  8  8  7  7  7  6  6  5  5  5  4  4  4  4  4  3  
8  8  8  8  8  7  7  7  6  6  6  5  5  5  5  4  4  4  4  4  
7  7  7  7  7  7  6  6  6  6  5  5  5  5  5  5  5  4  4  4  
6  6  6  6  6  6  6  6  6  5  5  5  5  5  5  5  5  5  4  4  
5  5  5  5  5  5  5  5  5  5  5  5  5  5  5  5  5  5  4  4  
4  4  4  4  4  4  5  5  5  5  5  5  5  5  5  5  5  5  4  4  
3  3  3  3  4  4  4  4  5  5  5  5  5  5  5  4  4  4  4  4  
3  3  3  3  3  3  4  4  4  4  4  4  4  5  4  4  4  4  4  4  
2  2  2  2  2  3  3  3  4  4  4  4  4  4  4  4  4  4  4  4  
2  2  2  2  2  2  3  3  3  3  4  4  4  4  4  4  4  4  4  5  
1  1  1  2  2  2  2  3  3  3  3  4  4  4  4  4  4  4  5  5  
1  1  1  1  1  2  2  2  3  3  3  3  4  4  4  5  5  5  5  5  
1  1  1  1  1  1  2  2  2  3  3  3  4  4  5  5  5  5  5  5  
1  1  1  1  1  1  2  2  2  2  3  3  4  4  5  5  5  5  5  5  
1  1  1  1  1  1  2  2  2  2  3  3  4  4  5  5  5  5  5  5  
1  1  1  1  1  2  2  2  2  2  3  3  4  4  4  5  5  5  5  5  
2  2  1  1  1  2  2  2  2  2  3  3  3  4  4  5  5  5  5  5  
