7  7  7  8  7  7  7  7  7  7  7  7  7  7  7  7  7  7  7  7  
7  7  7  7  7  7  7  7  7  7  7  7  7  7  7  7  7  7  7  7  
7  7  7  7  7  7  7  7  7  7  7  7  7  7  7  7  7  7  7  7  
7  7  7  7  7  7  7  7  7  7  7  7  7  7  7  7  7  7  7  7  
7  7  7  7  7  7  7  7  7  7  7  7  7  7  6  6  6  6  6  6  
6  6  6  6  6  6  6  6  6  6  6  6  6  6  6  6  6  6  6  6  
6  6  6  6  6  6  6  6  6  6  6  6  6  6  6  6  6  6  6  6  
5  5  6  6  6  6  6  6  6  6  6  6  6  6  6  6  6  6  6  6  
5  5  5  5  5  5  5  5  5  5  5  6  6  6  6  6  6  6  6  5  
5  5  5  5  5  5  5  5  5  5  5  5  5  5  5  5  5  5  5  5  
5  5  5  5  5  5  5  5  5  5  5  5  5  5  5  5  5  5  5  5  
4  4  4  5  5  5  5  5  5  5  5  5  5  5  5  5  5  5  5  5  
4  4  4  4  4  4  4  5  5  5  5  5  5  5  5  5  4  5  5  5  
4  4  4  4  4  4  4  4  4  4  4  4  4  4  4  4  4  4  5  5  
4  4  4  4  4  4  4  4  4  4  4  4  4  4  4  4  4  4  4  5  
3  3  4  4  4  4  4  4  4  4  4  4  4  4  4  4  4  4  4  4  
3  3  4  4  4  4  4  4  4  4  4  4  4  4  4  4  4  4  4  4  
3  3  4  4  4  4  4  4  4  4  4  4  4  4  4  4  4  4  4  4  
3  3  3  4  4  4  4  4  4  4  4  4  4  4  4  4  4  4  4  4  
3  3  3  3  4  4  4  4  4  4  4  4  4  4  4  4  4  4  4  4  
