3  3  2  2  2  1  1  1  0  0  0  0  0  0  0  0  0  0  0  0  
3  3  2  2  2  1  1  1  1  0  0  0  0  0  0  0  0  0  0  0  
3  3  3  2  2  2  1  1  1  1  0  0  0  0  0  0  0  0  0  0  
3  3  3  3  2  2  2  1  1  1  1  0  0  0  0  0  0  0  1  1  
4  4  3  3  3  2  2  1  1  1  1  1  0  0  0  0  1  1  1  1  
4  4  4  3  3  3  2  2  1  1  1  1  1  0  1  1  1  1  1  1  
5  5  4  4  4  3  3  2  2  2  1  1  1  1  1  1  1  1  1  2  
5  5  5  4  4  4  3  3  2  2  2  1  1  1  1  1  1  1  1  2  
5  5  5  5  4  4  3  3  3  2  2  2  1  1  1  1  1  1  2  2  
6  6  5  5  4  4  4  3  3  3  2  2  2  2  2  2  2  2  2  2  
6  6  6  5  5  5  4  4  4  3  3  3  2  2  2  2  2  2  2  2  
7  7  6  6  6  5  5  5  4  4  4  3  3  3  3  2  2  2  2  2  
7  7  7  7  6  6  5  5  5  5  4  4  4  4  3  3  3  3  3  2  
8  8  8  7  7  6  6  6  5  5  5  4  4  4  4  3  3  3  3  3  
8  8  8  7  7  6  6  6  5  5  5  5  5  4  4  4  3  3  3  3  
8  8  8  8  7  7  6  6  5  5  5  5  5  5  4  4  4  4  4  3  
8  8  8  8  7  7  6  6  5  5  5  5  5  5  4  4  4  4  4  3  
9  9  8  8  7  7  6  6  6  5  5  5  5  5  5  4  4  4  4  4  
9  9  8  8  8  7  7  6  6  6  5  5  5  5  5  5  5  5  5  4  
10 9  9  9  8  8  7  7  6  6  6  6  6  6  6  6  6  6  6  5  
