10 9  9  9  9  9  9  9  9  9  9  9  8  8  8  8  7  7  7  7  
9  9  9  9  9  9  9  9  9  9  9  9  8  8  8  8  8  7  7  7  
9  9  9  9  9  9  9  9  9  9  9  8  8  8  8  8  8  7  7  7  
9  9  9  9  9  9  8  8  8  8  8  8  8  8  8  7  7  7  7  7  
9  9  9  9  9  8  8  8  8  8  8  8  7  7  7  7  7  7  7  7  
9  9  9  8  8  8  8  7  7  7  7  7  7  7  7  6  6  6  6  6  
9  9  8  8  8  7  7  7  7  7  7  6  6  6  6  6  6  6  6  6  
9  8  8  8  7  7  7  6  6  6  6  6  5  5  5  5  5  5  5  5  
9  8  8  8  7  7  6  6  6  6  5  5  5  5  5  4  4  5  5  5  
8  8  8  8  7  7  6  6  6  5  5  5  4  4  4  4  4  4  4  4  
8  8  8  7  7  6  6  5  5  5  4  4  4  3  3  3  3  3  4  4  
7  7  7  7  6  6  5  5  4  4  3  3  3  3  2  2  2  3  3  3  
7  7  7  6  6  5  5  4  4  3  3  2  2  2  2  2  2  2  2  3  
6  6  6  6  5  5  4  4  3  3  2  2  2  2  2  2  2  2  2  2  
6  6  6  5  5  4  3  3  2  2  2  1  1  1  1  1  1  1  1  2  
6  6  6  5  5  4  3  3  2  2  1  1  1  1  1  1  1  1  1  1  
6  6  6  5  4  4  3  2  2  1  1  1  1  1  1  1  1  1  1  1  
6  6  5  5  4  4  3  2  2  1  1  1  1  1  1  1  1  1  1  1  
5  5  5  4  4  3  3  2  1  1  1  1  1  1  1  0  0  0  0  0  
4  4  4  4  3  3  2  1  1  0  0  0  0  0  0  0  0  0  0  0  
