10 10 9  8  7  6  5  4  3  2  1  1  1  0  0  1  1  1  1  2  
10 10 9  8  7  6  5  4  3  2  1  1  0  0  0  0  1  1  1  2  
10 10 9  8  7  6  5  4  3  2  1  0  0  0  0  0  0  1  1  2  
10 10 10 8  7  6  5  4  3  2  1  0  0  0  0  0  0  0  1  1  
11 10 10 9  8  6  5  4  3  2  1  1  0  0  0  0  0  0  0  1  
11 11 10 9  8  7  6  4  3  3  2  1  0  0  0  0  0  0  0  1  
11 11 10 10 9  7  6  5  4  3  2  1  0  0  0  0  0  0  0  1  
11 11 11 10 9  8  7  5  4  3  3  2  1  0  0  0  0  0  0  1  
11 11 11 10 9  8  7  6  5  4  3  2  1  1  0  0  0  0  0  1  
11 11 11 10 9  8  7  6  5  4  3  2  2  1  1  1  1  1  1  1  
11 11 11 10 10 9  8  7  6  5  4  3  3  2  2  1  1  1  1  1  
11 11 11 11 10 9  9  8  7  6  5  4  4  3  2  2  2  2  2  2  
11 11 11 11 10 10 9  8  8  7  6  5  4  4  3  3  3  3  2  2  
11 11 11 11 11 10 9  9  8  7  7  6  5  4  4  3  3  3  3  3  
11 11 11 11 11 10 10 9  9  8  7  6  5  5  4  3  3  3  3  3  
11 12 11 11 11 10 10 9  9  8  7  6  6  5  4  4  3  3  3  3  
11 11 11 11 11 10 10 9  9  8  7  7  6  5  4  4  3  3  3  3  
11 11 11 11 11 10 10 10 9  8  8  7  6  5  5  4  4  4  3  3  
11 11 11 11 11 11 10 10 9  8  8  7  6  6  5  5  4  4  4  4  
11 11 11 11 11 11 10 10 9  9  8  8  7  7  6  6  6  6  5  5  
