4  4  4  5  5  6  6  7  7  8  8  9  9  9  10 10 10 10 10 11 
4  4  4  5  5  6  6  7  7  7  8  8  9  9  10 10 10 10 10 10 
3  4  4  4  4  5  6  6  6  7  7  8  8  9  9  9  9  9  10 10 
3  3  3  4  4  4  5  5  6  6  7  7  8  8  8  9  9  9  9  9  
3  3  3  3  3  3  4  4  5  5  6  6  7  7  7  8  8  8  8  9  
2  2  2  3  3  3  3  3  4  4  5  5  5  6  6  6  6  7  7  7  
2  2  2  2  2  2  2  3  3  3  3  4  4  5  5  5  5  5  6  6  
2  2  2  2  2  2  2  2  2  2  3  3  3  3  4  4  4  4  5  5  
2  1  1  1  1  1  1  1  1  2  2  2  2  2  3  3  3  3  4  4  
1  1  1  1  1  1  1  1  1  1  1  1  2  2  2  2  2  2  3  3  
1  1  1  1  1  1  1  1  1  1  1  1  1  1  1  1  1  1  2  3  
1  1  1  1  1  1  0  0  0  0  0  0  0  1  1  1  1  1  1  2  
1  1  1  1  1  1  0  0  0  0  0  0  0  0  0  0  0  0  1  1  
1  1  1  1  1  0  0  0  0  0  0  0  0  0  0  0  0  0  1  1  
2  1  1  1  1  0  0  0  0  0  0  0  0  0  0  0  0  0  0  1  
2  2  1  1  1  1  0  0  0  0  0  0  0  0  0  0  0  0  0  1  
2  2  1  1  1  1  0  0  0  0  0  0  0  0  0  0  0  0  1  1  
2  2  2  1  1  1  0  0  0  0  0  0  0  0  0  0  0  0  1  1  
2  2  2  2  1  1  1  1  0  0  0  0  0  0  0  0  0  1  1  2  
3  3  3  2  2  2  1  1  1  1  1  1  1  1  1  1  1  1  2  2  
