6  5  5  5  4  4  3  3  2  2  2  1  1  1  0  0  1  1  1  1  
6  5  5  5  4  4  3  3  2  2  1  1  1  1  0  0  0  1  1  1  
6  6  5  5  4  4  3  3  2  2  1  1  1  1  0  0  0  0  1  1  
6  6  5  5  4  4  3  2  2  2  1  1  1  1  0  0  0  0  1  1  
6  6  5  5  4  4  3  2  2  2  1  1  1  0  0  0  0  0  0  1  
6  6  5  5  4  4  3  2  2  1  1  1  1  0  0  0  0  0  0  0  
6  6  6  5  4  4  3  2  2  1  1  1  0  0  0  0  0  0  0  0  
6  6  6  5  4  4  3  2  2  1  1  1  0  0  0  0  0  0  0  0  
6  6  6  5  5  4  3  2  2  1  1  1  0  0  0  0  0  0  0  0  
6  6  6  5  5  4  3  3  2  1  1  1  0  0  0  0  0  0  0  0  
7  6  6  6  5  4  3  3  2  2  1  1  0  0  0  0  0  0  0  0  
7  7  6  6  5  5  4  3  2  2  1  1  0  0  0  0  0  0  0  0  
7  7  7  6  6  5  4  3  3  2  2  1  0  0  0  0  0  0  0  0  
7  7  7  7  6  5  4  4  3  3  2  1  1  0  0  0  0  0  0  0  
8  7  7  7  6  5  5  4  3  3  2  1  1  0  0  0  0  0  0  0  
8  8  7  7  6  5  5  4  3  3  2  2  1  1  0  0  0  0  0  0  
8  8  7  7  6  6  5  4  4  3  2  2  1  1  0  0  0  0  0  0  
8  8  7  7  6  6  5  4  4  3  3  2  1  1  1  0  0  0  0  1  
8  8  8  7  7  6  6  5  4  4  3  2  2  1  1  1  1  1  1  1  
9  8  8  8  7  7  6  6  5  4  4  3  3  2  2  2  2  1  1  1  
